111111111111111
100100000000001
100001111111001
1000111000000C1
1P001E000000001
111111111111111
111111111111111
111111111111111